111111111111111111111111111
1C00101100000001000000000C1
1011C0000000C00000001100111
101010111111011010100110101
100P0000000C100010000010001
100110000100000C1000E0100C1
111111111111111111111111111
