1111111111111111111
10100100c0110010111
1000c00111000110001
1000001110000p00101
1111000010001101101
1000c0000000000e001
1111111111111111111
